20,20
11111111111111111111
11111100001111111111
11111101101100000000
11100000001101111111
11001101111101111111
11011100000001111111
11011111111111000011
11000000000000011011
11111111111111111011
11000000000000000011
11011111111111111111
11011111111111111111
11000000001111111111
11111111101111111111
11111111101111111111
11111111101111111111
11111111101111111111
11111111101111111111
11111111101111111111
11111111101111111111